0
-1000
.......&.....&......&......
...........................
....&....&.......&...&.....
.....*......*...*.....*....
...........................
.....*...*......***........
....*.........*....*...*...
.......*...................
...........................
...*.*...*..*****...*......
...........................
....*.....*......***.......
......*....................
....*....*.....**...*......
....&...&.....&............
....&...&.........&...&....
.......&....&...&..........
...*......*....*....*......
......*...........*........
..............*.......*....
...*....*......*...*.......
...........................
........*...*....*.........
...*....*....*..*....*..*..
..........*.....*..........
