0
-1000
**.*.&&&.*******.&&.**.&&.&
...........................
.....*.&.*&.*.*.&&.**.&**..
.......&.&.&&&.&&&.........
...........................
...&&&&.............&&&....
..........&...&&...........
..&.&.&.&..&...............
.....................*.....
...........................
...........*...............
.......................*...
.............*.....*.......
....**.....................
........*.......*.......*..
............*......*.......
....*........*.........*...
....*..*.........*.........
..*........*..*.....*....*.
......................*....
......*....................
..........*.*..*.*.........
.*....*.*..*..*..*.....*...
...........................
....*.*.*.*.*..*.*.*.*.....
...........................
.*.*.*.*.*.*.*.*.*.*.*.*.*.
...........................
...........................
